d
WWWW...B......
.........bbb..
..bbb........B
....B....bbb..
...bbb........
..B........B..
.......bbb...P
WWWWWWWWWWWWWW