..............
..............
..............
d............P
W.H.H.H.H.H.HW
W.....a......W
WWWWWWWWWWWWWW