WWWWWWWWWWWWWW
W............W
W............W
W............W
W............W
d....T..T..PRW
WWWWWWWWWWWWWW