WWWWWWWWWWWWWW
W............W
W.....z......W
W............W
W............W
WP...wwww....W
WWWWWWWWWWWWWW