.....................
.....................
....................P
W.................x.W
W...................W
W....o....y....o....W
W...................W