...................x
.....................
.....................
.....................
.....................
d.T.....T...T..TP.R..
WWWWWWWWWWWWWWWWWWWWW