..P..................
............H........
.....................
.....H..............d
W...................W
W.........a.........W
WWWWWWWWWWWWWWWWWWWWW