P........B...........
H...................B
.........H...B.......
....B...............H
.H.......C.......B..W
....................d
BBBBBBBBBBBBBBBBBBBBW