WWWWWWWWWWWWWW
W.....z......W
W.........C..W
W............W
W.C..........W
WP...wwww..C.W
WWWWWWWWWWWWWW