WWWWWWWWWWWWWWWWWWWWW
W...................W
P...................W
W.........b.........W
W...................W
W....o....y....o....W
W...................W