..............
.....H........
.........H....
d............P
W...........HW
W.....a......W
WWWWWWWWWWWWWW