WWWWWWWWWWWWWWWWWWWWW
W...................W
W.........C.........W
W...................W
W.C.................W
WP......wwRww..C....W
WWWWWWWWWWWWWWWWWWWWW