WWWWWWWWWWWWWWWWWWWWW
W...................W
P...................W
W.........e.........W
W...................W
W....o....y....o....d
WWWWWWWWWWWWWWWWWWWWW