..............
..............
..............
..............
..............
dT...T..T.P.R.
WWWWWWWWWWWWWW