......bbb...B........
W.W.....B....bbb.....
W.W...bbb...B....B...
W.W.....B....bbb.....
W.W.B..bbb........B..
W.W............B.....
W.W........bbb.......
WdW....B.....B...P...
WWWWWWWWWWWWWWWWWWWWW