d.........x..P
W............W
W............W
W.....a......W
W............W
W.....a......W
WWWWWWWWWWWWWW