P.........x.........W
W...................W
W...................d
W...................W
W...................W
W.........a.........W
WWWWWWWWWWWWWWWWWWWWW