WWWWWWWWWWWWWWWWWWWWW
W...................W
W.........C.........W
W...................W
W.C.................W
WP......wwFww..C....W
WWWWWWWWWWWWWWWWWWWWW