...C...............PT
...C...............WW
...C..............WWW
...C.............WWWW
...C............WWWWW
d..C..........WWWWWWW
WWWWWWWWWWWWWWWWWWWWW